tropical = {
}
arid = {
	769 833 897 961 1281 2049 2113 2241 2690  2754
	2945 3393 3457 3585  3591
}
arctic = {
	2885 2949 3013 3141 3333 3397 3461 3525 3589  3653
	3717 3719 3781 3845 3909 3973  4037
}
mild_winter = {
	261 325 388 389 452 453 516 517 580  581
	644 645 709 772 773 836 837 1157 1158  1222
	1286 1350 1414 1477 1478 1541 1542 1605 1606  1669
	1670 1733 1797 1857 1861 1921 1925 1985 1989  2053
	2117 2177 2178 2241 2242 2246 2305 2306 2369  2370
	2433 2434 2497 2498 2561 2625 2626 2689 2818  2882
	2946 3009 3010 3016 3073 3074 3137 3201 3329  3330
	3394 3521 3527 3649 3650 3713 3714 3777 3778  3780
	3841 3842 3905 3906 3970  4034
	67 712 840 904 968 1032 1288 1352 1416 1480
	1672 1736 1859 1923 1928 2056 
}
normal_winter = {
	69 133 197 901 965 1025 1029 1030 1089  1093
	1094 1153 1217 1221 1285 1345 1349 1409 1413  1473
	1537 1601 1665 1729 1793 2181 2245 2309 2373  2437
	2501 2562 3266 3271 3463 3522  3586
	3 776 1096 1160 1224 1475 1539 1603 1667 1731
	1795 1800 1864 1992 2179 3335 
}
severe_winter = {
	1 5 65 129 193 257 321 385 449  513
	577 641 705 2565 2629 2693 2757 2821 2885  2949
	3013 3077 3141 3205 3269 3333 3397 3399 3461  3525
	3589 3653 3655 3717 3719 3781 3845 3909 3973  4037
}
impassable = {
	3783  3975
}
mild_monsoon = {
}
normal_monsoon = {
}
severe_monsoon = {
	769 833 897 961 1281 2049 2113 2690 2754  2945
	3393 3457 3585  3591
}
